Yellow - 옐로우
Caramel - 카라멜
Lettuce - 레투스
Red - 레드
Tomato - 토마토
Croissant - 크로와상
Grape - 그레이프
Delivery - 딜리버리
Mint - 민트
Lemon - 레몬
Garage - 가라지
Blues - 블루스
Balcony - 발코니
Blue - 블루
Cookie - 쿠키
Drama - 드라마 
Radio - 라디오
Donut - 도넛 
Pancake - 팬케이크 
Bus - 버스
Wine - 와인
Juice - 쥬스 
Yogurt - 요거트 
Noodle - 누들 
Chocolate - 초콜릿 
Shopping - 쇼핑
Internet - 인터넷
vitamin - 비타민
menu - 메뉴
orange - 오렌지
night - 나이트
Computer - 컴퓨터 
meeting - 미팅
pen - 펜
sexy - 섹시
team - 팀
Sabrina - 사브리나
Coffee - 커피 
Hotel - 호텔
Mango - 망고
TV - 티비
cup - 컵
Taxi - 택시 
Pizza - 피자 
Camera - 카메라
Hamburger - 햄버거 
Sandwich - 샌드위치 
Baseball - 베이스볼
virus - 바이러스
butter - 버터
golf - 골프
allergy - 알러지
dollar - 달러
model - 모델
comedy - 코메디
Cinema - 시네마
Jean - 진
Muffin - 머핀
Soda - 소다
Whiskey - 위스키
Jacket - 자켓
Sofa - 소파
Camping - 캠핑
Festival - 페스티벌
stop - 스탑
Toilet - 토일렛
Laptop - 랩탑
Guitar - 기타
Romantic - 로맨틱
Vanilla - 바닐라
Strawberry - 스트로베리
Pasta - 파스타
Steak - 스테이크
Sneakers - 스니커즈
Notebook - 노트북
Bar - 바
Club - 클럽
Jazz - 재즈
Rap - 랩
Pop - 팝
Rock - 록
Yoga - 요가
Fitness - 피트니스
Concert - 콘서트
Snack - 스낵
Van - 밴
Truck - 트럭
Zoo - 주
Tour - 투어
Ticket - 티켓
Ice - 아이스
Picnic - 피크닉
Lounge - 라운지
Puzzle - 퍼즐
Zip - 집
Bagel - 베이글
Banana - 바나나
Cucumber - 큐컴버
Bacon - 베이컨
Tuna - 튜나
Cappuccino - 카푸치노
Espresso - 에스프레소
Latte - 라떼
Cheesecake - 치즈케이크
Fashion - 패션 
Restaurant - 레스토랑
Bottle - 바틀
Green - 그린
Monitor - 모니터
Skin - 스킨
Care - 케어
Getaway - 겟어웨이
Letter - 레터
Kitchen - 키친
Chicken - 치킨
Residential - 레지덴셜
Prudential - 프루덴셜
Synergy - 시너지
Mail - 메일
Station - 스테이션
Zoom - 줌
Excel - 엑셀
Word - 워드
Message - 메시지
Football - 풋볼
Korea - 코리아
America - 아메리카
Europe - 유럽
Africa - 아프리카
Lunch - 런치
Brunch - 브런치
Dinner - 디너
Wire - 와이어
Background - 백그라운드
Brown - 브라운
Poodle - 푸들
Retriever - 리트리버
Game - 게임
Gaming - 게이밍
Cry - 크라이
Love - 러브
Tennis - 테니스
Trouser - 트라우저
crayon - 크레용
Jeep - 지프